1111111111111111111111
1CCCCCCCCCCCCCCCCCCCC1
1CCCCCCCCCCCCCCCCCCCC1
1P111111111111111111E1
1111111111111111111111
