1111111111111
10010C1010101
10P111101E101
1000000000001
1111111111111
