111111
1P0001
1110C1
1E1001
111111
