1111111111111
1P00z00001111
1C000000a0011
1111111111111
