11111111111
1PE00000011
10000000001
11111111111
