1111111111111
1001000010101
10P100C01E101
1000000000001
1111111111111
