1111111111111
10P00010000C1
1000101C10001
100C1000100E1
1111111111111
