111111111111111111111111
100000000000000000000001
101001010010000010010101
101001001010101000010101
100000000C00C000000000C1
101001010010000010010101
101001001010101000010101
100000000C0EC000000000C1
101001010010000000010101
101001001010101010010101
100000000C00C000000000C1
101001010010000000010101
101001001010101010010101
1P0000000C00C000000000C1
111111111111111111111111
