1111111111111
100P00000C001
1000000000001
1000C0000C001
1000000000001
10C0000C00001
100000000E001
1111111111111
