1111111111111
1000000000001
10P00C0000E01
1000000000001
1111111111111
